502
2753 373 0 149 2231 29 0 3
0.129
x...................
x...................
.x..................
..x.................
...x......xxxx......
....x....x....x.x...
.....x...x.....x.x..
.....x..x.........x.
.....x...x.......x..
......xxx........x..
.................x..
..................x.
.................x..
..................x.
..................x.
.................x..
..................x.
.................x..
..................x.
...................x
502
<544444554332821233344244655464564644>
